################################################################################
#A                                                                             
# # ##### # # ############# # ####### # # ### ########### # ##### ##### # # ### 
#   # #   # #   #   #     # #     # # # #     #   #     #   #   # #     #     # 
# ### # ### ### # # # ### # # ### # # # ####### ### # # ##### # # ### ### ##### 
#     # #     # # # #   # # #   # # # #   #         # # #   # # #   # #   #     
# # ### # ##### # # ### # # ##### # # ### ########### ### # # # ### # ##### ### 
# # #   # #   #   #     # #       #   # # #   #       #   # # #   # #       #   
# # # ##### # ####### ### ######### ### # # # # ### ### ### # ### # ##### ### # 
#   #       #       #   #       #   #   #   #   #   #   #   # #     #   # #   # 
# ################# ### ####### # ##### ####### ##### ### ### ####### # ### ### 
#     #           #   #     #   # #     #     # #     # # #       #   #     #   
# ### # ### # ####### ### ### ### # # # # ### # # ##### # # ##### # ######### # 
# # # # # # # #     # #   #   #   # # # #   #   #   #     #     #       #   #   
# # # # # # # # ### # ##### ### ##### ### ######### ### ############### ### ### 
#   #     # # # # #   #   # # #     #     #       #   # #         #   #   #   # 
# ######### # # # ##### # # # ##### # ##### ##### # # # # ####### # # ### # ### 
# #         # #     #   #   #     # # #   # #     # # #   # #     # # #   # #   
# # # ############# # ####### # # # ### # # ##### ### ##### # ##### # # ### # # 
#   # #           # # #   #   # # #   # #   #   #     #     # #     # #     # # 
# ### # ####### ### # # # # ### ##### # # ### # ####### # # # ### # ####### # # 
# #   #       #     # # #   # # #   # # # #   #   #     # # #   # #         #   
# ########### ####### # ##### # # # # # ### ##### ####### # ### ############### 
#           #   #     #   #   #   #   #         #     #   #   #             #   
# ######### ### ##### ### # ########### ####### ##### # ##### ############# # # 
# #     # #   # #     #   # #           #   #   #     # #   #             #   # 
# # ### # ### # # ##### ### # ########### # ##### ##### # ##### ############### 
# # # #   #   #   #   # #           #     #       #     #       #           #   
# # # ### # # ##### ### # ######### # ############# ### # ####### ######### # # 
#   # #   # #       #   # #     #   #     #   #   #   # # #     #     #   #   # 
# ### # ### ######### ##### ### ######### # # # # ### # ### ### ##### ### ##### 
#                                                                              B
################################################################################
