###########
#A    #   #
### # ### #
#   #     #
# ### ### #
#     #   #
# ### # ###
#   #     B
###########