#################################################################################
#A                                                                              #
# # ##### # # ############# # ####### # # ### ########### # ##### ##### # # ### #
#   # #   # #   #   #     # #     # # # #     #   #     #   #   # #     #     # #
# ### # ### ### # # # ### # # ### # # # ####### ### # # ##### # # ### ### ##### #
#     # #     # # # #   # # #   # # # #   #         # # #   # # #   # #   #     #
# # ### # ##### # # ### # # ##### # # ### ########### ### # # # ### # ##### ### #
# # #   # #   #   #     # #       #   # # #   #       #   # # #   # #       #   #
# # # ##### # ####### ### ######### ### # # # # ### ### ### # ### # ##### ### # #
#   #       #       #   #       #   #   #   #   #   #   #   # #     #   # #   # #
# ################# ### ####### # ##### ####### ##### ### ### ####### # ### ### #
#     #           #   #     #   # #     #     # #     # # #       #   #     #   #
# ### # ### # ####### ### ### ### # # # # ### # # ##### # # ##### # ######### # #
# # # # # # # #     # #   #   #   # # # #   #   #   #     #     #       #   #   #
# # # # # # # # ### # ##### ### ##### ### ######### ### ############### ### ### #
#   #     # # # # #   #   # # #     #     #       #   # #         #   #   #   # #
# ######### # # # ##### # # # ##### # ##### ##### # # # # ####### # # ### # ### #
# #         # #     #   #   #     # # #   # #     # # #   # #     # # #   # #   #
# # # ############# # ####### # # # ### # # ##### ### ##### # ##### # # ### # # #
#   # #           # # #   #   # # #   # #   #   #     #     # #     # #     # # #
# ### # ####### ### # # # # ### ##### # # ### # ####### # # # ### # ####### # # #
# #   #       #     # # #   # # #   # # # #   #   #     # # #   # #         #   #
# ########### ####### # ##### # # # # # ### ##### ####### # ### ############### #
#           #   #     #   #   #   #   #         #     #   #   #             #   #
# ######### ### ##### ### # ########### ####### ##### # ##### ############# # # #
# #     # #   # #     #   # #           #   #   #     # #   #             #   # #
# # ### # ### # # ##### ### # ########### # ##### ##### # ##### ############### #
# # # #   #   #   #   # #           #     #       #     #       #           #   #
# # # ### # # ##### ### # ######### # ############# ### # ####### ######### # # #
#   # #   # #       #   # #     #   #     #   #   #   # # #     #     #   #   # #
# ### # ### ######### ##### ### ######### # # # # ### # ### ### ##### ### ##### #
#                                                                              B#
#################################################################################
