###########
#A#   #   #
# # # # # #
#   #   # #
### ### # #
#       # #
# ##### # #
#     #   #
# ### ### #
#   #    B#
###########
