################################################################################
#A                                                                             #
# # ##### # # ############# # ####### # # ### ########### # ##### ##### # # ####
#   # #   # #   #   #     # #     # # # #     #   #     #   #   # #     #     ##
# ### # ### ### # # # ### # # ### # # # ####### ### # # ##### # # ### ### ######
#     # #     # # # #   # # #   # # # #   #         # # #   # # #   # #   #    #
# # ### # ##### # # ### # # ##### # # ### ########### ### # # # ### # ##### ####
# # #   # #   #   #     # #       #   # # #   #       #   # # #   # #       #  #
# # # ##### # ####### ### ######### ### # # # # ### ### ### # ### # ##### ### ##
#   #       #       #   #       #   #   #   #   #   #   #   # #     #   # #   ##
# ################# ### ####### # ##### ####### ##### ### ### ####### # ### ####
#     #           #   #     #   # #     #     # #     # # #       #   #     #  #
# ### # ### # ####### ### ### ### # # # # ### # # ##### # # ##### # ######### ##
# # # # # # # #     # #   #   #   # # # #   #   #   #     #     #       #   #  #
# # # # # # # # ### # ##### ### ##### ### ######### ### ############### ### ####
#   #     # # # # #   #   # # #     #     #       #   # #         #   #   #   ##
# ######### # # # ##### # # # ##### # ##### ##### # # # # ####### # # ### # ####
# #         # #     #   #   #     # # #   # #     # # #   # #     # # #   # #  #
# # # ############# # ####### # # # ### # # ##### ### ##### # ##### # # ### # ##
#   # #           # # #   #   # # #   # #   #   #     #     # #     # #     # ##
# ### # ####### ### # # # # ### ##### # # ### # ####### # # # ### # ####### # ##
# #   #       #     # # #   # # #   # # # #   #   #     # # #   # #         #  #
# ########### ####### # ##### # # # # # ### ##### ####### # ### ################
#           #   #     #   #   #   #   #         #     #   #   #             #  #
# ######### ### ##### ### # ########### ####### ##### # ##### ############# # ##
# #     # #   # #     #   # #           #   #   #     # #   #             #   ##
# # ### # ### # # ##### ### # ########### # ##### ##### # ##### ################
# # # #   #   #   #   # #           #     #       #     #       #           #  #
# # # ### # # ##### ### # ######### # ############# ### # ####### ######### # ##
#   # #   # #       #   # #     #   #     #   #   #   # # #     #     #   #   ##
# ### # ### ######### ##### ### ######### # # # # ### # ### ### ##### ### ######
#                                                                              B
################################################################################
