#####################
#A# #               #
# # # ##### ####### #
# #   #     #     # #
# ### # ##### ### # #
#   # # #   # #   # #
### ### # # ### ### #
# #   # # #   #     #
# ### # # ### #######
#   # #     #       #
# ### ######### ### #
#   #         #   # #
# # ######### ##### #
# #                B#
#####################
