#####################################################################################################
#A #     #      #   #      #      #      #      #      #    #       #      #   #       #      #     #
# ## ### ## ### ## ### ### ## ### ## ### ### ## ### ## ### ## ### ## ### ## ### ## ### ## ### ## ####
#      #      #       #       #      #       #      #      #       #      #      #      #       #   #
### ### ### ### ### ### ### ### ### ### ### ### ### ### ### ### ### ### ### ### ### ### ### ### ### #
#   #      #       #      #      #       #      #      #      #      #       #      #       #       #
### ### ### ### ### ### ### ### ### ### ### ### ### ### ### ### ### ### ### ### ### ### ### ### ### #
#       #       #       #      #       #       #       #       #       #      #       #       #     #
### ### ### ### ### ### ### ### ### ### ### ### ### ### ### ### ### ### ### ### ### ### ### ### ### #
#      #      #       #       #      #       #      #       #       #       #      #       #        #
### ### ### ### ### ### ### ### ### ### ### ### ### ### ### ### ### ### ### ### ### ### ### ### ### #
#      #      #      #       #       #       #      #      #       #       #      #       #      #  #
### ### ### ### ### ### ### ### ### ### ### ### ### ### ### ### ### ### ### ### ### ### ### ### ### #
#       #       #      #       #      #       #      #       #       #       #      #       #       #
### ### ### ### ### ### ### ### ### ### ### ### ### ### ### ### ### ### ### ### ### ### ### ### ### #
#       #      #       #      #       #      #       #      #       #      #       #       #        #
### ### ### ### ### ### ### ### ### ### ### ### ### ### ### ### ### ### ### ### ### ### ### ### ### #
#       #       #       #      #       #       #       #       #       #       #       #       #    #
### ### ### ### ### ### ### ### ### ### ### ### ### ### ### ### ### ### ### ### ### ### ### ### ### #
#       #      #       #       #       #      #       #      #       #       #      #       #       #
### ### ### ### ### ### ### ### ### ### ### ### ### ### ### ### ### ### ### ### ### ### ### ### ### #
#       #       #       #      #       #       #      #       #       #      #       #       #      #
### ### ### ### ### ### ### ### ### ### ### ### ### ### ### ### ### ### ### ### ### ### ### ### ### #
#      #      #      #       #       #      #       #      #      #      #       #      #      #    #
### ### ### ### ### ### ### ### ### ### ### ### ### ### ### ### ### ### ### ### ### ### ### ### ### #
#       #       #      #       #       #       #      #       #       #       #      #       #      #
### ### ### ### ### ### ### ### ### ### ### ### ### ### ### ### ### ### ### ### ### ### ### ### ### #
#       #      #       #      #       #      #      #      #       #       #       #      #       # #
### ### ### ### ### ### ### ### ### ### ### ### ### ### ### ### ### ### ### ### ### ### ### ### ### #
#       #       #      #       #      #       #       #      #       #      #       #       #       #
### ### ### ### ### ### ### ### ### ### ### ### ### ### ### ### ### ### ### ### ### ### ### ### ### #
#       #      #       #       #       #      #       #      #       #       #      #       #       #
### ### ### ### ### ### ### ### ### ### ### ### ### ### ### ### ### ### ### ### ### ### ### ### ### #
#       #       #       #      #       #       #      #       #       #       #       #       #     #
### ### ### ### ### ### ### ### ### ### ### ### ### ### ### ### ### ### ### ### ### ### ### ### ### #
#       #      #       #      #       #      #       #       #      #       #       #      #        #
### ### ### ### ### ### ### ### ### ### ### ### ### ### ### ### ### ### ### ### ### ### ### ### ### #
#       #       #       #      #       #       #      #       #       #       #       #       #     #
### ### ### ### ### ### ### ### ### ### ### ### ### ### ### ### ### ### ### ### ### ### ### ### ### #
#       #      #       #      #       #      #      #       #       #       #      #       #        #
### ### ### ### ### ### ### ### ### ### ### ### ### ### ### ### ### ### ### ### ### ### ### ### ### #
#       #       #       #      #       #       #      #       #       #       #       #       #     #
### ### ### ### ### ### ### ### ### ### ### ### ### ### ### ### ### ### ### ### ### ### ### ### ### #
#       #      #       #      #       #      #       #      #       #       #       #      #        #
### ### ### ### ### ### ### ### ### ### ### ### ### ### ### ### ### ### ### ### ### ### ### ### ### #
#       #       #       #      #       #      #       #      #       #       #       #       #      #
### ### ### ### ### ### ### ### ### ### ### ### ### ### ### ### ### ### ### ### ### ### ### ### ### #
#       #      #       #      #       #      #      #       #       #       #      #       #        #
### ### ### ### ### ### ### ### ### ### ### ### ### ### ### ### ### ### ### ### ### ### ### ### ### #
#       #       #       #      #       #      #       #       #       #       #       #       #     #
### ### ### ### ### ### ### ### ### ### ### ### ### ### ### ### ### ### ### ### ### ### ### ### ### #
#       #      #       #      #       #      #      #       #       #       #      #       #        #
### ### ### ### ### ### ### ### ### ### ### ### ### ### ### ### ### ### ### ### ### ### ### ### ### #
#       #       #       #      #       #      #       #       #       #       #       #       #     #
### ### ### ### ### ### ### ### ### ### ### ### ### ### ### ### ### ### ### ### ### ### ### ### ### #
#       #      #       #      #       #      #      #       #       #       #      #       #        #
### ### ### ### ### ### ### ### ### ### ### ### ### ### ### ### ### ### ### ### ### ### ### ### ### #
#       #       #       #      #       #      #       #      #       #       #       #       #      #
### ### ### ### ### ### ### ### ### ### ### ### ### ### ### ### ### ### ### ### ### ### ### ### ### #
#       #      #       #      #       #      #       #      #       #       #      #       #        #
### ### ### ### ### ### ### ### ### ### ### ### ### ### ### ### ### ### ### ### ### ### ### ### ### #
#       #       #       #      #       #      #       #       #       #       #       #       #     #
### ### ### ### ### ### ### ### ### ### ### ### ### ### ### ### ### ### ### ### ### ### ### ### ### #
#       #      #       #      #       #      #      #       #       #       #      #       #        #
### ### ### ### ### ### ### ### ### ### ### ### ### ### ### ### ### ### ### ### ### ### ### ### ### #
#       #       #       #      #       #      #       #       #       #       #       #       #     #
### ### ### ### ### ### ### ### ### ### ### ### ### ### ### ### ### ### ### ### ### ### ### ### ### #
#       #      #       #      #       #      #      #       #       #       #      #       #        #
### ### ### ### ### ### ### ### ### ### ### ### ### ### ### ### ### ### ### ### ### ### ### ### ### #
#       #       #       #      #       #      #       #       #       #       #       #       #     #
### ### ### ### ### ### ### ### ### ### ### ### ### ### ### ### ### ### ### ### ### ### ### ### ### #
#       #      #       #      #       #      #       #      #       #       #       #      #        #
### ### ### ### ### ### ### ### ### ### ### ### ### ### ### ### ### ### ### ### ### ### ### ### ### #
#       #       #       #      #       #      #       #       #       #       #       #       #     #
### ### ### ### ### ### ### ### ### ### ### ### ### ### ### ### ### ### ### ### ### ### ### ### ### #
#       #      #       #      #       #      #      #       #       #       #      #       #        #
### ### ### ### ### ### ### ### ### ### ### ### ### ### ### ### ### ### ### ### ### ### ### ### ### #
#       #       #       #      #       #      #       #       #       #       #       #       #     #
### ### ### ### ### ### ### ### ### ### ### ### ### ### ### ### ### ### ### ### ### ### ### ### ### #
#       #      #       #      #       #      #      #       #       #       #      #       #        #
### ### ### ### ### ### ### ### ### ### ### ### ### ### ### ### ### ### ### ### ### ### ### ### ### #
#       #       #       #      #       #      #       #       #       #       #       #       #     #
### ### ### ### ### ### ### ### ### ### ### ### ### ### ### ### ### ### ### ### ### ### ### ### ### #
#       #      #       #      #       #      #      #       #       #       #      #       #        #
### ### ### ### ### ### ### ### ### ### ### ### ### ### ### ### ### ### ### ### ### ### ### ### ### #
#       #       #       #      #       #      #       #       #       #       #       #       #     #
### ### ### ### ### ### ### ### ### ### ### ### ### ### ### ### ### ### ### ### ### ### ### ### ### #
#       #      #       #      #       #      #       #      #       #       #      #       #        #
### ### ### ### ### ### ### ### ### ### ### ### ### ### ### ### ### ### ### ### ### ### ### ### ### #
#       #       #      #       #      #       #       #      #       #       #       #       #      #
### ### ### ### ### ### ### ### ### ### ### ### ### ### ### ### ### ### ### ### ### ### ### ### ### #
#       #      #       #      #       #      #      #       #       #       #      #       #        #
### ### ### ### ### ### ### ### ### ### ### ### ### ### ### ### ### ### ### ### ### ### ### ### ### #
#       #       #       #      #       #      #       #       #       #       #       #       #     #
### ### ### ### ### ### ### ### ### ### ### ### ### ### ### ### ### ### ### ### ### ### ### ### ### #
#       #      #       #      #       #      #      #       #       #       #      #       #        #
### ### ### ### ### ### ### ### ### ### ### ### ### ### ### ### ### ### ### ### ### ### ### ### ### #
#       #       #      #       #      #       #       #       #       #       #       #       #     #
### ### ### ### ### ### ### ### ### ### ### ### ### ### ### ### ### ### ### ### ### ### ### ### ### #
#       #      #       #      #       #      #      #       #       #       #      #       #        #
### ### ### ### ### ### ### ### ### ### ### ### ### ### ### ### ### ### ### ### ### ### ### ### ### #
#       #       #       #      #       #      #       #       #       #       #       #       #     #
### ### ### ### ### ### ### ### ### ### ### ### ### ### ### ### ### ### ### ### ### ### ### ### ### #
#       #      #       #      #       #      #      #       #       #       #      #       #        #
### ### ### ### ### ### ### ### ### ### ### ### ### ### ### ### ### ### ### ### ### ### ### ### ### #
#       #       #       #      #       #      #       #       #       #       #       #       #     #
### ### ### ### ### ### ### ### ### ### ### ### ### ### ### ### ### ### ### ### ### ### ### ### ### #
#       #      #       #      #       #      #      #       #       #       #      #       #        #
### ### ### ### ### ### ### ### ### ### ### ### ### ### ### ### ### ### ### ### ### ### ### ### ### #
#       #       #       #      #       #      #       #       #       #       #       #       #     #
### ### ### ### ### ### ### ### ### ### ### ### ### ### ### ### ### ### ### ### ### ### ### ### ### #
#       #      #       #      #       #      #      #       #       #       #      #       #        #
### ### ### ### ### ### ### ### ### ### ### ### ### ### ### ### ### ### ### ### ### ### ### ### ### #
#       #       #       #      #       #      #       #       #       #       #       #       #     #
### ### ### ### ### ### ### ### ### ### ### ### ### ### ### ### ### ### ### ### ### ### ### ### ### #
#       #      #       #      #       #      #      #       #       #       #      #       #        #
### ### ### ### ### ### ### ### ### ### ### ### ### ### ### ### ### ### ### ### ### ### ### ### ### #
#       #       #       #      #       #      #       #       #       #       #       #       #    B#
#####################################################################################################

